# # # # # # # # # # # # # #
# . . . . . . . . . . . . #
# . . . . . . . . . . . . #
# . . . . . . . . . . . . #
# . . . . . . . . . . . . #
# . . . . . . . . . . . . #
# . . . . . . . . . . . . #
# . . . . . . . . . . . . #
# . . . . . . . . . . . . #
# . . . . . . . . . . . . #
# . . . . . . . . . . . . #
# . . . . . . . . . . . . >
# . . . . . . . . . . . . #
# # # # # # # # # # # # # #

