# # # # # # # # # # # # # #
# , , , , , , . . . . . . #
# , , , , , , , . . . . . #
# , , , , , . . . . . . . #
# . . , , . . . . . . . . #
# . . . , . . . . . . . . #
# . . . . . . . . . . . . #
# . . . . . . . . . . . . #
# . . . . . . . . . . . . #
# . . . . . . . . . . . . #
# . . . . . . . . . . . . #
< . . . . . . . . . . . . #
# . . . . . . . . . . . . #
# # # # # # # # # # # # # #

